1111111111111
100100C0000C1
11
1C00011111001
1P0011E000001
1111111111111